"a" = (/turf/template_noop,/area/template_noop)
"e" = (/obj/machinery/light{dir = 4},/obj/machinery/button/door{id = "QMLoaddoor"; name = "Loading Doors"; pixel_x = 26; pixel_y = 4},/turf/open/floor/mineral/titanium/blue,/area/shuttle/supply)
"f" = (/obj/machinery/light{dir = 1},/turf/open/floor/mineral/titanium/blue,/area/shuttle/supply)
"l" = (/obj/structure/shuttle/engine/propulsion,/turf/open/floor/plating/airless,/area/shuttle/supply)
"q" = (/obj/machinery/button/door{id = "QMLoaddoor"; name = "Loading Doors"; pixel_x = 26; pixel_y = 4},/turf/open/floor/mineral/titanium/blue,/area/shuttle/supply)
"w" = (/obj/machinery/light{dir = 8},/turf/open/floor/mineral/titanium/blue,/area/shuttle/supply)
"B" = (/obj/machinery/conveyor{dir = 4; id = "QMLoad"},/turf/open/floor/mineral/titanium/blue,/area/shuttle/supply)
"C" = (/obj/machinery/door/poddoor{id = "QMLoaddoor"; name = "Supply Dock Loading Door"},/obj/machinery/conveyor{dir = 4; id = "QMLoad"},/obj/docking_port/mobile/supply{width = 11},/turf/open/floor/mineral/titanium/blue,/area/shuttle/supply)
"J" = (/obj/machinery/light,/turf/open/floor/mineral/titanium/blue,/area/shuttle/supply)
"L" = (/obj/structure/shuttle/engine/heater,/obj/structure/window/reinforced{dir = 1},/turf/open/floor/plating/airless,/area/shuttle/supply)
"X" = (/obj/machinery/door/airlock/titanium{name = "Supply Shuttle Airlock"; req_access_txt = "31"},/turf/open/floor/mineral/titanium/blue,/area/shuttle/supply)
"Y" = (/turf/open/floor/mineral/titanium/blue,/area/shuttle/supply)
"Z" = (/turf/closed/wall/mineral/titanium,/area/shuttle/supply)

(1,1,1) = {"
ZZZZZZZ
ZYYfYYZ
ZYYYYYZ
ZYYYYYX
ZwYYYeZ
ZYYYYBC
ZYYYYqZ
ZYYYYYX
ZZYJYZZ
ZZLLLZZ
allllla
"}
